60 58 58 58 58 58 58 58 58 58 58 58 58 58 58 58 58 58 58 58 58 58 58 58 58 58 58 58 58 58 58 58 58 58 58 58 58 58 58 58 58 58 58 58 59
57  1  1  1  1  1  1  1  1  1  1  1  1  1  1  1  1  1  1  1  1  1  1  1  1  1  1  1  1  1  1  1  1  1  1  1  1  1  1  1  1  1  1  1 51
57  1  1  1  1  1  1  1  1  1  1  1  1  1  1  1  1  1  1  1  1  1  1  1  1  1  1  1  1  1  5  9  1  1  1  1  1  1  1  1  1  1  1  1 51
57  1  1  1  1  1  1  1  1  1  1  1  1  1  1  1  1  1  1  1  1  1  1  1  1  1  1  1  1  1 22 49  1  1  1  1  1  1  1  1  1  1  1  1 51
57  1  1  1  1  1  1  1  1  1  1  1  1  1  1  1  1  1 18 18 18 18  1  1  1  1  1  1  1  1  1  1  1  1  1  1  1  1  1  1  1  1  1  1 51
57  1  1 18  1  1  1  5  9  1  1  1  1  1 18 18 18 18  1  1  1 18 18 18 18 18 18  1  1  1  1  1 18 18 18 18 18 18 18  1  1  1  1  1 51
57  1  1 18 18  1  1 22 49  1  1  1  1  1  1  1  1  1  1  1  1  1 18 18  1  1  1  1  1  1  1 18 18  1  1  1  1  1  1  1  1  1  1  1 51
57  1  1  1 18 18  1  1  1  1  1  1  1  1  1  1  1  1  1  1  1  1  1  1  1  1  1  1  1  1  1 18  1  1  1  1  1  1  1  1  1  1  1  1 51
57  1  1  1  1 18 18  1  1  1  1  1  1  1  1  1  1  1  1  1  1  1  1  1  1  5  9  1  1  1  1 18  1  1  1  1  1  1  1  5  9  1  1  1 51
57  1  1  1  1 18 18  1  1  1  1  1  1  5  9  1  1  1  1  1  1  1  1  1  1 22 49  1  1  1  1  1  1  1  1  1  1  1  1 22 49  1  1  1 51
57  1  1  1  1 18  1  1  1  1  1  1  1 22 49  1  1  1  1  1  1  1  1  1  1  1  1  1  1  1  1  1  1  1  1  1  1  1  1  1  1  1  1  1 51
57  1  1  1  1 18  1  1  1  1  1  1  1  1  1  1  1  1  1  1  1  1  1  1  1  1  1  1  1  1  1  1  1  1  1  1  1  1  1  1  1  1  1  1 51
57  1  1  1  1 18 18  1  1  1  1  1  1  1  1  1  1  1  1  1  1  1  1  1  1  1  1  1  1  1  1  1  1  1  1  1  1  1  1  1  1  1  1  1 51
57  1  1  1  1  1 18  1  1 18  1  1  1  1  1  1  1  1  1  1 18 18  1  1  1  1  1  1  1  1  1  1  1  1  1  1  1  1  1  1  1  1  1  1 51
57  1  1  1  1  1  1  1  1 18 18  1  1  1  1  1  1  1  1  1  1  1 18  1  1  1  1  1  1  1  1  1  1  5  9  1  1  1  1  1  1  1  1  1 51
57  1  1  1  1  5  9  1  1  1 18  1  1  1  1  1  1  1  1  1  1  1  1 18 18 18  1 18 18  1  1  1  1 22 49  1  1  1  1  1 18  1  1  1 51
57  1  1  1  1 22 49  1  1  1 18  1  1  1  1  1  1  1  1  1  1  1  1  1  1 18 18 18  1  1  1  1  1  1  1  1  1  1  1 18 18  1  1  1 51
57  1  1  1  1  1  1  1  1  1 18 18 18 18  1  1  1  1  1  1  1  1  1  1  1  1  1  1  1  1  1  1  1  1  1  1  1  1 18 18  1  1  1  1 51
57  1  1  1  1  1  1  1  1  1 18  1  1  1  1  1  1  5  9  1  1  1  1  1  1  1  1  1  1  1  1  1  1  1  1  1  1 18 18  1  1  1  1  1 51
57  1  1  1  1  1  1  1  1  1 18  1  1  1  1  1  1 22 49  1  1  1  1  1  1  1  1  1  1  1  1  1  1  1  1  1  1  1  1  1  1  1  1  1 51
57  1  1  1  1  1  1  1  1  1  1  1  1  1  1  1  1  1  1  1  1  1  1  1  1  1  1  1  1  1  1  1  1  1  1  1  1  1  1  1  1  1  1  1 51
57  1  1  1  1  1  1  1  1  1  1  1  1  1  1  1  1  1  1  1  1  1  1  1  1  1  1  1  1  1  1  1  1  1  1  1  1  1  1  1  1  1  1  1 51
63 53 53 53 53 53 53 53 53 53 53 53 53 53 53 53 53 53 53 53 53 53 53 53 53 53 53 53 53 53 53 53 53 53 53 53 53 53 53 53 53 53 53 53 64 